1111111111111
10010C0001C11
1C0E011111E01
1P0011E001001
1111111111111