1111111111111
10010C0000C11
1C00011111001
1P0011E000001
1111111111111