111111111
1P0000C11
1000X11E1
1C0011001
1X0110001
1100000C1
111111111