111111111
10E0000C1
11P100001
11C100011
111111111
